xxxxxxxxxxxxxxxxxxxxxxxxxx
x                        x
x                         
                         x
x                        x
x                        x
x                         
                          
x                        x
x                         
xxxxxxxxxxxxxxx           
             x  x         
             x    x      x
x            x      x     
x            x          x
x            x          xx
x                       x
x            x           x
xxxxxxxxxxxxxxxxxxxxxxxxxx
