xxxxxxxxxxxxxxxxxxxxxxxxxxxxxxxxxxxxxxxxxxxxxxxxxx
x                                                x
x                                                x
x                                                x
x                         ooo                    x
x                         o o                    x
x                         ooo                    x
x                                                x


x                                                x
x                                                x
xxxxxxxxxxxxxxxxxxxxxxxxxxxxxxxxxxxxx            x
x                                   x            x
x                                  x             x
x                                 x              x
x                                x               x
x           xxxx x x            x
x                                                x
xxxxxxxxxxxxxxxxxxxxxxxxxxxxxxxxxxxxxxxxxxxxxxxxxx
